NO assets/m1.xpm
SO assets/3.xpm
WE assets/1.xpm
EA assets/m4.xpm

F 192,192,192           
C 153,255,255

1111111111111111111111111111111111111
10000000001100000000011000100000000001
10110000011100000000000011110000000001
10010000000000000000000011110000000001
11111111100000000000000000000000000001
10000000000000000111011111110000000001
11110111111111011100000010000000000001
11111111110000011101010010000000000001
11000000010001011100000010000000000001
10001000000000000000000001000000000001
1000N100010000110101001000000000000001
11001000000000011111010000000001110011
11111111111111111111111111111111111111
