NO ./path_to_the_north_texture
SO ./path_to_the_south_texture
WE ./path_to_the_west_texture
EA ./path_to_the_east_texture

F 220,100,0              
C 225,30,0

11111111111111111111111111111
10000000001100000000011000101
10110000011100000000000011111
10010000000000000000000011111
11111111100000000000000000001
10000000000000000111011111111
11110111111111011100000010001
11110111111111011101010010001
11000000110101011100000010001
10000000000000011000000100001
100000N0000000001101010010001
11000000000101011111011110011
11111111111111111111111111111
