NO assets/1.xpm
SO assets/2.xpm
WE assets/3.xpm
EA assets/wall4.xpm

F 192,192,192           
C 153,255,255

11111111111111111111111111111111111111
10000000001100000000011000100000000001
10110000011100000N00000011110000000001
10010000000000000000000011110000000001
11111111100000010000000000000000000001
10000000000000001111011111110000000001
11110111111111011100000010000000000001
11110111110000011101010010000000000001
11000000000001011100000010000000000001
10000001100000000000000001000000000001
10000011100000110101001000000000000001
11000011100000011111010000000001110011
11111111111111111111111111111111111111
